####################################################
# ############                         #############
# ############         ##############  #############
# #  #                 #######     ##    ########  #
# #  #                       ###  ##     ##    ##  #
# #  #                         ####      ##    ##  #
# ####                          ##       ###  ###  #
# ####                                    ######   #
#  #             #######                   ####    #
#  #             #######                    ##     #
#  #             #######                           #
#  #                                               #
#  #                                               #
#  #                                               #
#                           ###                    #
#                           ###                    #
#                           ###                    #
#                           ###                    #
#                                                  #
#                   ####   ###                     #
#       ##          ####   ###                     #
#       ##          #  #   ###                     #
#                   #  #   ###        #  ##        #
#       #           #  #   ###        #   #        #
#       #           #  #   ###        # # #        #
#       #  ####     #  #              # # #        #
#       #  ####     #  #              # # #        #
#       #  ####     #  #              #   #        #
#       #  ####     #  #               ###         #
#                      #                           #
#                      #                           #
#                      #                           #
#                   #  #                           #
#          ####     #  #                           #
#          #  #     #  #                           #
#          ####     #  #                           #
#                   #  #     ######            #####
#                   #  #     ######          # #####
#                   ####     ######          # #####
#        #####               ######          # ## ##
#        #####                               # ## ##
#                                            # ## ##
#                 ######                     # ## ##
#                                            # ## ##
#     #####                                  # ## ##
#     #   #                                  # #####
#     ##################                     # #####
#                      #                     #     #
#                      ####                  #     #
#                          ######            #     #
#                                                  #
####################################################
