###########
#       # #
#  #    # #
#  #    # #
#  #      #
#     #   #
#         #
###########
