######################
#                    #
#      #             #
#                    #
#               ###  #
#               #    #
#               #    #
#               ######
#                    #
#                    #
#                    #
#                    #
#                    #
#                    #
#         #          #
#        ###         #
#         #          #
#                    #
#        ###         #
#         #          #
#         ####       #
#            #       #
#            ####### #
#                  # #
#      #           # #
######################
