#################################
###############   ###############
#############  #   ##############
############    #   #############
###########      ##  ############
###########           ###########
###########   ##      ###########
########  #  #   ## # ###########
######    #  #   ## # ###########
#####      # #        ###    ####
####       # #  #### ##        ##
####  # #   #       #    #   #  #
####   # #   #           #   #  #
#####  #  #   #####          # ##
######    #              #    ###
#######  #         ##############
#########  ##     ###############
#########   ##### ###############
########          ###############
#######  ##    ##  ##############
######     #  #     #############
####        ##      #############
##         ###       ############
#         ###         ###########
#         ###         ###########
#################################
