#####
#  ##
##  #
#  ##
#####
