#################################
##### #  #                  #####
###  # ## ################## ####
###  ######                  ####
#      ##                    ####
#      ###                    ###
###  #####                    ###
###  ######                   ###
##### #####                   ###
###### ####                   ###
####### ####               ######
##         #            #########
##         #         ############
##         ##     ############ ##
##         ### ############## # #
#          ##   #######      ## #
##            #               # #
##                           ## #
#                           ## ##
##         #             ##### ##
##         ##  ############### ##
##          ##           ##### ##
##          ##           ##### ##
##          ##           ##### ##
##          ##           ##### ##
##          ##           ##### ##
##          ##           ##### ##
##         ################### ##
### ########################## ##
### ########################## ##
###                            ##
## ############## ############# #
# ############### ###############
#                               #
#################################
