###################
# #               #
# # ### # #########
#   #   #         #
# ### ######### # #
# #   #       # # #
# ##### ##### ### #
#   #       # #   #
### # ##### # #   #
#   # #   # # # # #
### # # # # # # # #
#   #   # # #     #
# ####### #########
#       # #       #
##### # # # ##### #
#   # # #   #   # #
# ### # ####    # #
#     #      #  # #
###################
