#############################################
#   #########################################
#     #######################################
##  #   #####################################
##  ##         ##############################
##  ##          #############################
###  #           ############################
####  #           #   #######################
####  ##               ######################
###    ##              ######################
####   ##               #####################
######  ##               ####################
######  ##                ###################
######  ###                ##################
#######  ###               ##################
########  ###              ##################
######### ####             ##################
###############            ##################
###############            #############    #
################           ############     #
################            ###########    ##
###############              #########     ##
################             #########     ##
#################              ###        ###
##################                     ######
#####################                  ######
#######################                 #####
##########################     ##   #########
################################### #########
#############################################
