########
#      #
# ###  #
#      #
#      #
#   ## #
#      #
########
