############################################################################
#                                                                          #
#    ****   ****   ****   ****   ****   ****   ****   ****   ****   ****   #
#     **     **     **     **     **     **     **     **     **     **    #
#     **     **     **     **     **     **     **     **     **     **    #
#     **     **     **     **     **     **     **     **     **     **    #
#     **     **     **     **     **     **     **     **     **     **    #
#     **     **     **     **     **     **     **     **     **     **    #
#     **     **     **     **     **     **     **     **     **     **    #
#     **     **     **     **     **     **     **     **     **     **    #
#     **     **     **     **     **     **     **     **     **     **    #
#     **     **     **     **     **     **     **     **     **     **    #
#     **     **     **     **     **     **     **     **     **     **    #
#     **     **     **     **     **     **     **     **     **     **    #
#     **     **     **     **     **     **     **     **     **     **    #
#     **     **     **     **     **     **     **     **     **     **    #
#     **     **     **     **     **     **     **     **     **     **    #
#     **     **     **     **     **     **     **     **     **     **    #
#     **     **     **     **     **     **     **     **     **     **    #
#     **     **     **     **     **     **     **     **     **     **    #
#    ****   ****   ****   ****   ****   ****   ****   ****   ****   ****   #
#                                                                          #
#                                                                          #
#                                                                          #
#                                                                          #
#                                                                          #
#    ****   ****   ****   ****   ****   ****   ****   ****   ****   ****   #
#     **     **     **     **     **     **     **     **     **     **    #
#     **     **     **     **     **     **     **     **     **     **    #
#     **     **     **     **     **     **     **     **     **     **    #
#     **     **     **     **     **     **     **     **     **     **    #
#     **     **     **     **     **     **     **     **     **     **    #
#     **     **     **     **     **     **     **     **     **     **    #
#     **     **     **     **     **     **     **     **     **     **    #
#     **     **     **     **     **     **     **     **     **     **    #
#     **     **     **     **     **     **     **     **     **     **    #
#     **     **     **     **     **     **     **     **     **     **    #
#     **     **     **     **     **     **     **     **     **     **    #
#     **     **     **     **     **     **     **     **     **     **    #
#     **     **     **     **     **     **     **     **     **     **    #
#     **     **     **     **     **     **     **     **     **     **    #
#     **     **     **     **     **     **     **     **     **     **    #
#     **     **     **     **     **     **     **     **     **     **    #
#     **     **     **     **     **     **     **     **     **     **    #
#    ****   ****   ****   ****   ****   ****   ****   ****   ****   ****   #
#                                                                          #
############################################################################
